###############
# #     ###   #
S       ###   #
#   ###  #    #
#   ###     # #
#   ###     # #
#    #    ### #
# ##   #      E
# ##   #      #
###############
